42 40 40 40 40 40 40 40 40 40 40 40 40 40 40 40 40 40 40 40 40 40 40 40 40 40 40 40 40 40 40 40 40 40 40 40 40 40 40 40 40 40 40 40 40 40 40 40 40 40
42 12 32 12 12 12 12 12 12 12 12 12 12 12 34 12 12 12 15 12 12 12 34 12 12 12 12 12 12 35 12 12 12 12 12 35 35 35 35 35 35 35 35 35 35 35 35 35 35 40
42 34 12 12 16 23 22 12 16 23 22 12 12 12 12 12 32 12 12 12 12 12 12 12 12 12 12 12 12 12 35 12 12 12 12 12 12 35 35 35 35 35 35 35 35 35 35 35 35 40
42 12 12 12 17 24 21 12 17 24 21 12 12 12 12 12 12 12 12 12 12 12 12 34 12 12 12 12 12 12 12 12 12 37 44 43 12 12 35 35 35 35 35 35 35 35 35 35 35 40
42 12 12 12 18 19 20 12 18 19 20 12 12 12 12 12 32 12 15 12 12 12 12 12 12 12 12 12 35 12 12 35 12 38 36 42 12 12 35 35 35 35 35 35 35 35 35 35 35 40
42 12 34 12 12 12 12 12 12 12 12 12 16 23 22 12 12 12 12 12 37 44 43 12 12 12 12 12 12 12 12 12 12 39 40 41 12 12 35 35 35 35 35 35 35 35 35 35 35 40
42 16 23 22 12 32 12 12 12 12 12 12 17 24 21 12 12 12 12 12 38 36 42 12 12 12 12 35 12 12 12 12 12 12 12 12 35 35 35 35 35 35 35 35 35 35 35 35 35 40
42 17 24 21 12 12 12 45 12 12 12 34 18 19 20 12 12 12 34 12 39 40 41 12 12 12 12 12 12 12 13 34 12 12 12 12 35 35 35 35 35 35 35 35 35 35 35 35 35 40
42 18 19 20 12 12 12 12 12 12 12 13 13 12 12 12 12 12 12 12 12 12 12 34 12 12 12 12 12 12 12 12 12 12 12 35 35 12 12 12 12 12 12 12 12 35 35 35 35 40
42 12 12 12 12 12 12 12 12 13 13 13 12 12 12 13 12 12 34 12 12 12 32 12 12 12 12 12 12 12 12 12 12 35 35 12 12 12 12 12 12 37 44 43 12 35 35 35 35 40
42 12 12 12 12 10 11 12 13 13 15 12 13 13 12 13 12 12 12 12 12 12 12 12 12 34 12 12 12 35 12 12 35 12 12 12 12 12 12 12 12 38 36 42 12 35 35 35 35 40
42 12 12 12 15 12 12 12 12 12 12 12 13 13 34 12 12 12 12 12 12 12 12 34 34 12 12 12 12 12 12 35 27 12 12 12 12 12 12 12 12 39 40 41 12 35 35 35 35 40
42 12 12 12 12 12 12 12 13 12 13 32 13 13 13 12 12 12 12 12 12 12 34 12 12 12 13 12 12 12 12 27 27 27 27 12 27 12 12 12 12 12 12 12 12 35 35 35 35 40
42 32 34 12 12 12 12 12 13 12 13 12 13 13 12 12 12 12 12 34 12 12 12 12 12 12 12 12 12 12 27 27 27 27 27 27 27 27 27 30 30 30 30 30 30 30 30 30 30 40
42 12 34 12 12 12 15 12 12 12 13 12 13 13 12 12 32 12 12 12 12 12 12 12 12 12 12 12 27 27 27 27 27 27 27 27 30 30 30 30 30 30 30 30 30 30 30 30 30 40
42 12 12 12 12 12 12 12 13 13 12 12 13 13 12 12 12 12 12 12 12 12 12 12 12 12 12 27 27 27 27 27 27 27 27 30 30 30 30 30 30 30 30 30 30 30 30 30 30 40
42 12 12 12 12 15 12 12 12 13 12 12 13 34 34 12 12 12 12 12 12 34 12 12 12 12 27 27 27 27 27 27 27 27 30 30 30 30 30 30 30 30 30 30 30 30 30 30 30 40
42 12 12 12 15 12 12 12 13 13 12 12 13 12 12 12 12 12 12 34 12 12 12 13 12 27 27 27 27 27 27 27 29 27 27 30 30 30 30 30 30 30 30 30 30 30 30 30 30 40
42 12 12 13 15 12 15 12 12 13 12 12 12 13 12 12 12 12 12 12 12 12 12 12 12 27 27 27 27 27 27 27 27 27 27 27 27 27 27 30 30 30 30 30 30 30 30 30 30 40
42 15 12 13 12 13 12 34 12 12 34 34 12 13 12 12 12 12 12 13 13 12 12 12 27 27 27 27 27 27 27 27 29 27 27 27 27 27 27 30 30 30 30 30 30 30 30 30 30 40
42 15 12 25 12 12 12 12 12 12 12 12 12 12 12 25 25 12 12 25 25 25 25 25 27 27 27 27 27 27 27 27 27 27 27 27 27 27 27 27 27 27 27 27 27 27 27 27 27 40
42 13 12 25 25 25 12 12 12 25 12 12 25 25 25 25 25 25 25 25 25 25 25 25 27 27 27 30 27 27 27 27 27 27 27 27 27 29 27 27 27 27 27 27 27 27 27 27 27 40
42 26 25 25 25 25 12 25 25 25 25 25 25 25 25 25 25 25 25 25 25 25 25 27 27 27 27 27 27 29 27 27 27 27 27 27 27 27 27 27 27 27 27 27 27 27 27 27 27 40
42 25 25 31 25 26 25 25 25 25 25 25 26 25 25 25 25 25 25 25 25 25 27 27 27 27 29 27 29 27 27 27 28 27 27 27 29 27 27 27 27 27 27 27 27 27 27 27 27 40
42 25 25 25 25 25 25 25 25 26 25 25 25 25 26 25 25 25 25 25 25 27 27 27 27 27 27 27 27 27 27 27 27 27 27 27 27 27 27 27 27 27 27 27 27 27 27 27 27 40
42 25 25 25 25 25 25 25 25 25 25 25 25 25 25 25 25 25 25 25 25 27 27 27 27 27 27 27 27 27 29 27 27 27 27 28 27 27 27 27 27 27 27 27 27 27 27 27 27 40
42 25 25 25 25 25 25 25 25 25 25 25 25 25 25 25 25 25 25 25 27 27 27 29 27 27 29 27 30 27 27 27 27 27 27 27 27 27 30 27 27 27 27 27 27 27 27 27 27 40
42 25 25 25 25 25 25 25 25 25 25 25 25 25 25 25 25 25 25 25 27 27 27 27 30 27 27 27 27 27 27 27 27 27 27 27 27 27 27 27 27 27 27 27 27 27 27 27 27 40
42 25 25 25 25 25 25 25 25 25 25 25 25 25 31 25 25 25 25 25 27 27 27 30 27 27 29 27 27 27 27 27 27 27 27 27 27 29 27 27 27 27 27 27 27 27 27 27 27 40
42 25 25 25 25 25 25 25 25 25 26 25 25 25 25 25 25 25 25 27 27 27 27 30 27 27 27 27 27 27 27 27 27 27 27 27 27 30 27 27 27 27 27 27 27 27 27 27 27 40
42 25 25 26 25 25 25 25 25 25 25 25 25 25 25 25 25 25 27 27 27 30 27 27 27 27 27 30 27 27 27 27 27 27 27 27 27 27 29 27 27 27 27 27 27 27 27 27 27 40
42 25 25 25 25 25 25 25 25 25 25 25 25 25 25 25 25 25 27 27 27 27 27 27 27 27 29 27 27 27 27 27 27 27 27 27 27 27 27 27 27 27 27 27 27 27 27 27 27 40
42 25 25 25 25 25 25 25 25 25 25 25 25 25 25 25 25 25 27 27 27 27 27 27 27 27 27 27 27 27 27 27 27 27 27 27 27 27 30 27 27 27 27 27 27 27 27 27 27 40
42 25 25 25 25 25 25 25 26 25 25 25 25 25 25 25 25 25 27 27 27 27 27 27 27 30 27 27 27 27 27 27 27 27 27 27 27 27 27 27 27 27 27 27 27 27 27 27 27 40
42 25 31 25 25 25 25 25 25 25 25 25 25 25 25 25 25 25 27 27 30 27 27 30 27 27 27 27 27 27 30 27 27 27 27 27 27 27 27 27 27 27 27 27 27 27 27 27 27 40
42 25 25 25 25 25 25 25 25 25 25 25 25 25 25 25 25 27 27 27 27 27 27 27 27 30 27 27 27 27 27 27 27 27 27 30 27 27 30 27 27 27 27 27 27 27 27 27 27 40
42 25 25 25 25 25 25 25 25 25 26 25 25 25 25 25 25 25 27 27 27 27 27 27 27 27 27 27 27 27 27 27 27 27 27 27 27 27 27 27 27 30 27 27 27 27 27 27 27 40
42 25 25 25 25 25 25 25 25 25 25 25 25 25 25 25 25 25 27 27 27 27 27 27 27 27 27 29 27 27 27 27 27 27 27 27 27 27 27 27 27 30 27 27 27 27 27 27 27 40
42 25 25 26 25 25 25 25 25 25 31 25 25 25 25 25 25 25 27 27 27 27 27 27 27 27 27 27 27 27 27 27 27 27 27 27 27 27 27 27 27 27 27 27 27 27 27 27 27 40
42 25 25 25 25 25 25 25 25 25 25 25 25 25 25 25 25 25 27 27 27 27 27 27 27 27 27 27 27 27 27 27 27 27 27 27 27 27 27 27 27 30 27 27 27 27 27 27 27 40
42 25 25 25 25 25 25 25 25 25 25 25 25 25 25 25 25 25 27 27 27 27 27 27 27 27 27 27 27 27 27 27 27 27 27 27 27 27 27 27 27 30 27 27 27 27 27 27 27 40
42 25 25 25 25 25 25 25 25 25 25 25 25 25 25 25 25 25 27 27 27 27 27 27 27 27 27 27 27 27 27 30 27 27 27 27 27 27 27 27 27 27 27 27 27 27 27 27 27 40
42 25 25 25 31 25 25 25 25 25 25 25 25 25 25 25 25 25 27 27 27 27 27 27 27 27 27 27 27 27 27 27 27 27 27 27 27 27 27 27 27 27 27 27 27 27 27 27 27 40
42 25 25 25 25 25 25 25 25 25 25 25 25 26 25 25 25 25 27 27 27 27 27 27 27 27 27 27 27 27 27 27 27 27 27 27 27 27 27 27 27 30 27 27 27 27 27 27 27 40
42 25 25 25 25 25 25 25 25 25 25 25 25 25 25 25 25 25 27 27 27 27 27 27 27 27 27 27 30 27 27 27 27 27 27 27 27 27 27 27 27 27 27 27 27 27 27 27 27 40
42 25 25 25 25 25 25 26 25 25 25 25 25 25 25 25 25 25 27 27 27 27 27 27 27 27 27 27 27 27 27 27 27 27 27 27 27 27 27 27 27 30 27 27 27 27 27 27 27 40
42 25 26 25 25 25 25 25 25 25 25 25 25 25 25 25 25 25 27 27 27 27 27 27 27 27 27 27 27 27 27 27 27 30 27 27 27 27 27 27 27 30 27 27 27 27 27 27 27 40
42 25 25 25 25 25 25 25 25 25 25 25 25 25 25 25 25 25 27 27 27 27 27 27 27 27 27 27 27 27 27 27 27 27 27 27 27 27 27 27 27 30 27 27 27 27 27 27 27 40
42 25 31 25 25 25 25 25 25 25 25 25 26 25 25 25 25 25 27 27 27 27 27 27 27 27 27 27 27 30 27 27 27 27 27 27 27 27 27 27 27 30 27 27 27 27 27 27 27 40
40 40 40 40 40 40 40 40 40 40 40 40 40 40 40 40 40 40 40 40 40 40 40 40 40 40 40 40 40 40 40 40 40 40 40 40 40 40 40 40 40 40 40 40 40 40 40 40 40 40