23 23 23 23 23 23 24 23 23 23 23 23 23 23 23 23 23 23 23 23 23 23 23 23 23 23 23 23 23 23 24 23 23 23 23 23 23 23 24 24 23 23 23 23 23 23 23 23 23 23 
23 23 24 24 23 23 23 23 23 23 23 23 23 23 23 23 23 23 23 23 24 23 23 23 23 23 23 23 23 24 23 23 23 23 23 23 23 23 23 23 23 23 24 24 23 23 23 23 23 23 
24 24 23 23 23 23 23 23 23 23 23 23 23 24 24 24 23 23 23 23 23 23 23 23 23 23 23 23 23 23 23 23 23 23 23 23 23 23 23 23 23 23 23 23 23 24 23 23 23 23 
24 23 23 23 23 23 23 23 23 23 23 23 23 23 23 23 23 23 23 23 23 23 23 23 23 23 23 23 23 23 23 23 23 23 23 23 23 23 23 23 23 23 23 23 23 23 23 23 23 23 
23 23 23 23 23 28 28 28 28 28 28 28 28 28 28 28 28 28 28 28 28 28 28 28 28 28 28 28 28 28 28 28 28 28 28 28 28 28 28 28 28 28 28 28 28 23 23 23 23 23 
23 23 23 23 26 10 10 10 10 10 10 10 10 10 10 10 10 10 10 10 43 46 43 46 43 46 43 46 43 46 10 10 10 10 10 10 10 10 10 10 10 10 10 10 10 27 23 23 23 23 
23 23 23 23 26 10 10 10 10 10 10 10 10 10 10 10 10 10 10 10 44 45 44 45 44 45 44 45 44 45 10 10 10 10 10 10 10 10 10 10 10 10 10 10 10 27 23 23 23 23 
23 24 23 23 26 10 10 10 10 10 10 10 10 10 10 10 10 43 46 32 39 39 39 39 39 39 39 39 39 38 43 46 10 10 10 10 10 10 10 10 10 10 10 10 10 27 23 23 23 23 
23 24 23 23 26 10 10 10 10 10 10 10 10 10 10 10 10 44 45 33 20 20 20 20 20 20 20 20 20 37 44 45 10 10 10 10 10 10 10 10 10 10 10 10 10 27 23 24 23 23 
23 23 23 23 26 10 10 10 10 10 10 10 10 10 10 10 10 43 46 33 20 20 20 20 20 20 20 20 20 37 43 46 10 10 10 10 10 10 10 10 10 10 10 10 10 27 23 23 23 23 
23 23 23 23 26 10 10 10 10 10 10 10 10 10 10 10 10 44 45 33 20 20 20 20 40 20 20 20 20 37 44 45 10 10 10 10 10 10 10 10 10 10 10 10 10 27 23 23 23 23 
23 23 23 23 26 10 10 10 10 10 10 10 10 10 10 10 10 43 46 33 20 20 20 20 20 20 20 20 20 37 43 46 10 10 10 10 10 10 10 10 10 10 10 10 10 27 23 23 23 23 
23 23 23 23 26 10 10 10 10 10 10 10 10 10 10 10 10 44 45 34 35 35 35 20 20 20 35 35 35 36 44 45 10 10 10 10 10 10 10 10 10 10 10 10 10 27 23 23 23 23 
23 23 23 23 26 10 10 10 10 10 10 10 10 10 10 10 10 10 10 10 10 43 46 12 20 16 43 46 10 10 10 10 10 10 10 10 10 10 10 10 10 10 10 10 10 27 23 24 23 23 
23 23 24 23 26 10 10 10 10 10 10 10 10 10 10 10 10 10 10 10 10 44 45 12 20 16 44 45 10 10 10 10 10 10 10 10 10 10 10 10 10 10 10 10 10 27 23 23 23 23 
23 23 23 23 26 10 10 10 10 10 10 10 10 10 10 10 10 10 10 10 10 10 10 12 20 16 10 10 10 10 10 10 10 10 10 10 10 10 10 10 10 10 10 10 10 27 23 23 23 23 
23 23 23 23 26 10 10 10 10 10 10 10 10 10 10 10 10 10 10 10 10 43 46 12 19 16 43 46 10 10 10 10 10 10 10 10 10 10 10 10 10 10 10 10 10 27 23 23 23 23 
23 23 23 23 26 10 10 10 10 10 10 10 10 10 10 10 10 10 10 10 10 44 45 12 20 16 44 45 10 10 10 10 10 10 10 10 10 10 10 10 10 10 10 10 10 27 23 23 23 23 
23 23 23 23 26 10 10 10 10 10 10 10 10 10 10 10 10 10 10 10 10 10 10 12 20 16 10 47 52 53 58 10 10 10 10 10 10 10 10 10 10 10 10 10 10 27 23 23 23 23 
23 23 23 23 26 10 10 10 10 10 10 10 10 10 10 10 10 10 10 10 10 10 10 12 20 16 10 48 51 54 57 10 10 10 10 10 10 10 10 10 10 10 10 10 10 27 23 23 23 23 
23 23 23 23 26 10 10 10 10 10 10 10 10 10 10 47 52 53 58 10 10 10 11 20 20 20 17 49 50 55 56 10 10 10 10 10 10 10 10 10 10 10 10 10 10 27 23 23 23 24 
23 23 23 23 26 10 10 10 10 10 10 10 10 10 10 48 51 54 57 10 59 59 12 20 20 20 20 18 18 18 18 18 18 18 17 10 10 10 10 10 10 10 10 10 10 27 23 23 23 23 
23 23 23 23 26 10 10 10 10 10 10 10 10 10 10 49 50 55 56 59 10 59 12 20 20 20 20 20 19 20 20 20 20 20 16 10 10 10 10 10 10 10 10 10 10 27 23 23 23 23 
23 23 23 23 26 10 10 10 10 10 10 10 10 10 10 10 10 10 10 29 30 31 12 19 20 20 20 14 14 14 14 14 14 14 15 10 10 10 10 10 10 10 10 10 10 27 23 23 23 23 
23 23 24 23 26 10 10 10 10 10 10 10 10 10 11 18 18 18 18 18 18 18 12 20 20 20 16 10 43 46 10 10 10 10 10 10 10 10 10 10 10 10 10 10 10 27 23 23 24 23 
23 23 23 23 26 10 10 10 10 10 10 10 10 10 12 20 20 20 20 20 20 20 20 20 20 20 16 10 44 45 10 10 10 10 10 10 10 10 10 10 10 10 10 10 10 27 23 23 24 23 
23 23 23 23 26 10 10 10 10 10 10 10 10 10 13 14 14 14 14 14 14 14 20 20 20 20 16 10 10 10 10 10 10 10 10 10 10 10 10 10 10 10 10 10 10 27 23 23 24 23 
23 23 23 23 26 10 10 10 10 10 10 10 10 10 10 10 10 10 10 10 10 10 12 20 19 20 16 10 43 46 10 10 10 10 10 10 10 10 10 10 10 10 10 10 10 27 23 24 23 23 
23 23 23 23 26 10 10 10 10 10 10 10 10 10 10 10 10 10 10 10 10 10 12 20 20 20 16 10 44 45 10 10 10 10 10 10 10 10 10 10 10 10 10 10 10 27 23 24 23 23 
23 23 23 23 26 10 10 10 10 10 10 10 10 10 10 43 46 10 47 52 53 58 12 20 20 20 15 10 10 10 10 10 10 10 10 10 10 10 10 10 10 10 10 10 10 27 23 24 23 23 
23 23 23 23 26 10 10 10 10 10 10 10 10 10 10 44 45 10 48 51 54 57 12 20 20 16 47 52 53 58 10 10 10 10 10 10 10 10 10 10 10 10 10 10 10 27 23 23 23 23 
23 23 23 23 26 10 10 10 10 10 10 10 10 10 10 10 10 10 49 50 55 56 12 20 20 16 48 51 54 57 10 10 10 10 10 10 10 10 10 10 10 10 10 10 10 27 23 23 23 23 
23 23 23 23 26 10 10 10 10 10 10 10 10 10 10 11 18 18 18 18 18 18 19 20 20 16 49 50 55 56 10 10 10 10 10 10 10 10 10 10 10 10 10 10 10 27 23 23 23 23 
23 23 23 23 26 10 10 10 10 10 10 10 10 10 10 12 20 20 20 20 20 20 20 20 20 16 10 10 10 10 10 10 10 10 10 10 10 10 10 10 10 10 10 10 10 27 23 23 23 23 
23 23 23 23 26 10 10 10 10 10 10 10 10 10 10 13 14 14 14 14 14 14 20 20 20 20 18 18 18 18 18 17 10 10 10 10 10 10 10 10 10 10 10 10 10 27 23 23 23 23 
23 23 23 23 26 10 10 10 10 10 10 10 10 10 10 10 10 10 10 10 10 10 12 20 20 20 20 20 20 20 20 16 10 10 10 10 10 10 10 10 10 10 10 10 10 27 23 23 23 23 
23 23 23 23 26 10 10 10 10 10 10 10 10 10 10 10 10 10 10 43 46 10 12 20 20 20 14 14 14 14 14 15 10 10 10 10 10 10 10 10 10 10 10 10 10 27 23 23 23 23 
23 23 23 23 26 10 10 10 10 10 10 10 10 10 10 10 10 10 10 44 45 10 12 20 20 16 10 10 10 10 10 10 10 10 10 10 10 10 10 10 10 10 10 10 10 27 23 24 23 23 
23 23 23 23 26 10 10 10 10 10 10 10 10 10 10 10 10 10 10 10 10 10 12 20 19 16 10 10 10 10 10 10 10 10 10 10 10 10 10 10 10 10 10 10 10 27 23 23 23 23 
23 23 23 23 26 10 43 46 10 10 10 10 10 10 10 10 10 10 10 10 10 10 12 20 20 16 10 10 10 10 10 10 10 10 10 10 10 10 10 10 10 10 10 10 10 27 23 23 23 23 
23 23 23 23 26 10 44 45 10 10 10 10 10 10 10 10 10 10 10 43 46 10 12 20 20 16 43 46 10 10 10 10 10 10 10 10 10 10 10 10 10 10 10 10 10 27 23 23 23 23 
23 23 23 23 26 10 10 10 10 10 10 10 10 10 10 10 10 10 10 44 45 10 12 19 20 16 44 45 10 10 10 10 10 10 10 10 10 10 10 10 10 10 10 10 10 27 23 23 23 23 
23 23 23 23 26 10 43 46 10 10 10 10 10 10 10 10 10 10 10 10 10 10 12 20 20 16 10 10 10 10 10 10 10 10 10 10 10 10 10 10 10 10 10 10 10 27 23 23 23 23 
23 23 23 23 26 10 44 45 10 10 10 10 10 10 10 10 10 10 10 10 10 10 12 20 20 16 10 10 10 10 10 10 10 10 10 10 10 10 10 10 10 10 10 10 10 27 23 23 23 23 
23 23 23 23 26 10 10 10 10 10 10 10 10 10 10 10 10 10 10 10 10 10 12 20 20 16 10 10 10 10 10 10 10 10 10 10 10 10 10 10 10 10 10 10 10 27 23 23 23 24 
23 23 23 23 23 25 25 25 25 25 25 25 25 25 25 25 25 25 25 25 25 25 25 25 25 25 25 25 25 25 25 25 25 25 25 25 25 25 25 25 25 25 25 25 25 23 23 23 23 23 
23 23 23 23 23 24 23 23 23 23 23 23 23 23 23 23 23 23 23 23 23 23 23 23 23 23 23 23 23 23 23 23 23 23 23 23 23 23 23 23 24 23 23 23 23 23 23 23 23 23 
23 24 23 23 24 23 23 23 23 23 23 23 23 24 23 23 23 23 23 23 23 23 23 23 23 23 23 23 23 23 23 23 23 23 23 23 23 23 23 24 23 23 23 23 23 23 23 23 23 24 
23 23 24 24 23 23 23 23 23 23 23 23 23 23 23 23 23 23 23 23 23 23 23 23 24 23 23 23 23 24 24 24 24 24 24 24 23 23 24 24 23 23 24 23 23 23 23 23 23 23 
23 24 23 23 23 23 23 23 23 23 23 23 23 23 23 23 23 23 23 23 24 23 23 23 23 23 24 24 24 24 23 23 23 23 23 23 23 24 24 23 23 23 23 23 23 23 23 23 23 23
