42 42 42 42 42 42 42 42 42 42 42 42 42 42 42 42 42 42 42 42 42 42 42 42 42 42 42 42 42 42 42 42 42 42 42 42 42 42 42 42 42 42 42 42 42 42 42 42 42 42 
42 42 42 42 42 42 42 42 42 42 42 42 42 42 42 42 42 42 42 42 42 42 42 42 42 42 42 42 42 42 42 42 42 42 42 42 42 42 42 42 42 42 42 42 42 42 42 42 42 42 
42 42 42 42 42 42 42 42 42 42 42 42 42 42 42 42 42 42 42 42 42 42 42 42 42 42 42 42 42 42 42 42 42 42 42 42 42 42 42 42 42 42 42 42 42 42 42 42 42 42 
42 42 42 42 42 42 42 42 41 41 41 41 41 41 41 41 41 41 41 41 41 41 41 41 41 41 41 41 41 41 41 41 41 41 41 41 41 42 42 42 42 42 42 42 42 42 42 42 42 42 
42 42 42 42 42 42 42 42 41 41 41 41 41 41 41 41 41 41 41 41 41 41 41 41 41 41 41 41 41 41 41 41 41 41 41 41 41 42 42 42 42 42 42 41 41 41 41 41 42 42 
42 42 42 42 42 42 42 42 41 41 41 41 41 41 41 41 41 41 41 41 41 41 41 41 41 41 41 41 41 41 41 41 41 41 41 41 41 42 42 42 42 42 42 41 41 41 41 41 42 42 
42 42 42 42 42 42 42 42 41 41 41 41 41 41 41 41 41 41 41 41 41 41 41 41 41 41 41 41 41 41 41 41 41 41 41 41 41 42 42 42 42 42 42 41 41 41 41 41 42 42 
42 42 42 42 42 42 42 42 41 41 41 41 41 41 41 41 41 41 41 41 41 41 41 41 41 41 41 41 41 41 41 41 41 41 41 41 41 41 41 41 41 41 41 41 41 41 41 41 42 42 
42 42 42 42 42 42 42 42 41 41 41 41 41 41 41 41 41 41 41 41 41 41 41 41 41 41 41 41 41 41 41 41 41 41 41 41 41 41 41 41 41 41 41 41 41 41 41 41 42 42 
42 42 42 42 42 42 42 42 41 41 41 41 41 41 41 41 41 41 41 41 41 41 41 41 41 41 41 41 41 41 41 41 41 41 41 41 41 42 42 42 42 42 42 41 41 41 41 41 42 42 
42 42 42 42 42 42 42 42 41 41 41 41 41 41 41 41 41 41 41 41 41 41 41 41 41 41 41 41 41 41 41 41 41 41 41 41 41 42 42 42 42 42 42 41 41 41 41 41 42 42 
42 42 42 42 42 42 42 42 41 41 41 41 41 41 41 41 41 41 41 41 41 41 41 41 41 41 41 41 41 41 41 41 41 41 41 41 41 42 42 42 42 42 42 41 41 41 41 41 42 42 
42 42 42 42 42 42 42 42 41 41 41 41 41 41 41 41 41 41 41 41 41 41 41 41 41 41 41 41 41 41 41 41 41 41 41 41 41 42 42 42 42 42 42 41 41 41 41 41 42 42 
42 42 42 42 42 42 42 42 41 41 41 41 41 41 41 41 41 41 41 41 41 41 41 41 41 41 41 41 41 41 41 41 41 41 41 41 41 42 42 42 42 42 42 42 42 42 42 42 42 42 
42 42 42 42 42 42 42 42 42 42 42 42 42 42 42 42 42 42 42 42 42 42 42 42 41 41 41 42 42 42 42 42 42 42 42 42 42 42 42 42 42 42 42 42 42 42 42 42 42 42 
42 42 42 42 42 42 42 42 42 42 42 42 42 42 42 42 42 42 42 42 42 42 42 42 41 41 41 42 42 42 42 42 42 42 42 42 42 42 42 42 42 42 42 42 42 42 42 42 42 42 
42 42 42 42 42 42 42 42 42 42 42 42 42 42 42 42 42 42 42 42 42 42 42 42 41 41 41 42 42 42 42 42 42 42 42 42 42 42 42 42 42 42 42 42 42 42 42 42 42 42 
42 42 42 42 42 42 42 42 42 42 42 42 42 42 42 42 42 42 42 42 42 42 42 42 41 41 41 42 42 42 42 42 42 42 42 42 42 42 42 42 42 42 42 42 42 42 42 42 42 42 
42 42 41 41 41 41 42 42 42 41 41 41 41 41 41 41 41 41 41 41 41 41 41 41 41 41 41 42 42 42 42 42 42 42 42 42 42 42 42 42 42 42 42 42 42 42 42 42 42 42 
42 42 41 41 41 41 42 42 42 41 41 41 41 41 41 41 41 41 41 41 41 41 41 41 41 41 41 42 42 42 42 42 42 42 42 42 42 42 42 42 42 42 42 42 42 42 42 42 42 42 
42 42 41 41 41 41 41 41 41 41 41 42 42 42 42 42 42 42 42 42 42 42 42 42 42 42 42 42 42 42 42 42 42 42 42 42 42 42 42 42 42 41 41 41 41 41 41 41 42 42 
42 42 41 41 41 41 41 41 41 41 41 42 42 42 42 42 42 42 42 42 42 42 42 42 42 42 42 42 42 42 42 42 42 42 42 42 42 42 42 42 42 41 41 41 41 41 41 41 42 42 
42 42 41 41 41 41 42 42 42 41 41 42 42 42 42 42 42 42 42 42 42 42 42 42 42 42 42 42 42 42 42 42 42 42 42 42 42 42 42 42 42 41 41 41 41 41 41 41 42 42 
42 42 41 41 41 41 42 42 42 41 41 41 42 42 42 42 42 42 42 42 42 42 42 42 42 42 42 42 42 42 42 42 42 42 42 42 42 42 42 42 42 41 41 41 41 41 41 41 42 42 
42 42 41 41 41 41 42 42 42 41 41 41 42 42 42 42 42 42 42 42 42 42 42 42 42 42 42 42 42 42 42 42 42 42 42 42 42 42 42 42 42 42 42 42 41 41 42 42 42 42 
42 42 42 42 42 42 42 42 42 41 41 41 41 41 41 41 41 42 42 42 42 42 42 42 42 42 42 42 42 42 42 42 42 42 42 42 42 42 42 42 42 42 42 42 41 41 42 42 42 42 
42 42 42 42 42 42 42 42 42 41 41 41 41 41 41 41 41 42 42 42 42 42 42 42 42 42 42 42 42 42 42 42 42 42 42 42 42 42 42 42 42 42 42 42 41 41 42 42 42 42 
42 42 42 42 42 42 42 42 42 42 42 42 42 42 42 41 41 41 41 41 41 41 41 41 41 41 41 41 41 41 41 41 41 41 41 41 41 41 41 41 41 41 41 41 41 41 41 41 41 42 
42 42 42 42 42 42 42 42 42 42 42 42 42 42 42 41 41 41 41 41 41 41 41 41 41 41 41 41 41 41 41 41 41 41 41 41 41 41 41 41 41 41 41 41 41 41 41 41 41 42 
42 42 42 42 42 42 42 42 42 42 42 42 42 42 42 41 41 42 42 42 42 42 42 42 42 42 42 42 42 42 42 42 42 42 41 41 42 42 42 41 41 41 41 41 41 41 41 41 41 42 
42 42 42 42 42 42 42 42 42 42 42 42 42 42 42 41 41 42 42 42 42 42 42 42 42 42 42 42 42 42 42 42 42 42 41 41 42 42 42 41 41 41 41 41 41 41 41 41 41 42 
42 42 42 42 42 42 42 42 42 42 42 42 42 42 42 41 41 42 42 42 42 42 42 42 42 42 42 42 42 42 42 42 42 42 41 41 42 42 42 41 41 41 41 41 41 41 41 41 41 42 
42 41 41 41 41 42 42 42 42 42 42 42 42 42 42 41 41 42 42 42 42 42 42 42 42 42 42 42 42 42 42 42 42 42 41 41 42 42 42 41 41 41 41 41 41 41 41 41 41 42 
42 41 41 41 41 42 42 42 42 42 42 41 41 41 41 41 41 41 41 41 41 41 42 42 42 42 42 42 42 42 42 42 42 42 41 41 42 42 42 41 41 41 41 41 41 41 41 41 41 42 
42 41 41 41 41 42 42 42 42 42 42 41 41 41 42 42 42 42 42 42 41 41 42 42 42 42 42 42 42 42 42 42 42 42 41 41 42 42 42 41 41 41 41 41 41 41 41 41 41 42 
42 41 41 41 41 42 42 42 42 42 42 41 41 41 42 42 42 42 42 42 41 41 42 42 42 42 42 42 42 42 42 42 42 42 41 41 42 42 42 41 41 41 41 41 41 41 41 41 41 42 
42 41 41 41 41 42 42 42 42 42 42 41 41 41 42 42 42 42 42 42 41 41 42 42 42 42 42 42 42 42 42 42 42 42 41 41 42 42 42 42 41 41 41 41 41 41 41 41 41 42 
42 41 41 41 41 41 41 41 41 41 41 41 41 41 42 42 42 42 42 42 41 41 42 42 42 42 42 42 42 42 42 42 42 42 41 41 42 42 42 42 42 41 41 41 41 41 41 41 42 42 
42 41 41 41 41 41 41 41 41 41 41 41 41 41 42 42 42 42 42 42 41 41 42 42 42 42 42 42 42 42 42 42 42 42 41 41 42 42 42 42 42 42 42 42 42 42 41 41 42 42 
42 41 41 41 41 42 42 42 42 42 42 41 41 41 42 42 42 42 42 42 41 41 42 42 42 42 42 42 42 42 42 42 42 42 41 41 42 42 42 42 42 42 42 42 42 42 41 41 42 42 
42 41 41 41 41 42 42 42 42 42 42 41 41 41 42 42 42 42 42 42 41 41 42 42 42 42 42 42 42 42 42 42 42 42 41 41 42 42 42 42 42 42 42 42 42 42 41 41 42 42 
42 41 41 41 41 42 42 42 42 42 42 41 41 41 42 42 42 42 42 42 41 41 42 42 42 42 42 42 42 42 42 42 42 42 41 41 42 42 42 42 42 42 42 42 42 42 41 41 42 42 
42 41 41 41 41 42 42 42 42 42 42 41 41 41 41 41 41 41 41 41 41 41 41 41 41 41 41 41 41 42 42 42 42 42 41 41 42 42 42 42 42 42 42 42 42 42 41 41 42 42 
42 41 41 41 41 42 42 42 42 42 42 41 41 41 41 41 41 41 41 41 41 41 41 41 41 41 41 41 41 42 42 42 42 41 41 41 41 42 42 42 42 42 42 42 42 42 41 41 42 42 
42 41 41 41 41 42 42 42 42 42 42 42 42 42 42 42 42 42 41 41 41 42 42 42 42 42 42 41 41 42 42 42 42 41 41 41 41 42 42 42 42 42 42 42 42 42 41 41 42 42 
42 42 42 42 42 42 42 42 42 42 42 42 42 42 42 42 42 42 41 41 41 42 42 42 42 42 42 41 41 41 41 41 41 41 41 41 41 42 42 42 42 42 42 42 42 42 41 41 42 42 
42 42 42 42 42 42 42 42 42 42 42 42 42 42 42 42 42 42 41 41 41 42 42 42 42 42 42 41 41 41 41 41 41 41 41 41 41 41 41 41 41 41 41 41 41 41 41 41 42 42 
42 42 42 42 42 42 42 42 42 42 42 42 42 42 42 42 42 42 41 41 41 42 42 42 42 42 42 42 42 42 42 42 42 41 41 41 41 41 41 41 41 41 41 41 41 41 41 41 42 42 
42 42 42 42 42 42 42 42 42 42 42 42 42 42 42 42 42 42 41 41 41 42 42 42 42 42 42 42 42 42 42 42 42 41 41 41 41 42 42 42 42 42 42 42 42 42 42 42 42 42 
42 42 42 42 42 42 42 42 42 42 42 42 42 42 42 42 42 42 41 41 41 42 42 42 42 42 42 42 42 42 42 42 42 42 42 42 42 42 42 42 42 42 42 42 42 42 42 42 42 42
